0000000000000000000000000000000000000000
0222222222222222222222222222222222222220
0200002002000020000000000200002002000020
0202222222222222022222202222222222222020
0202002002000002020000202000002002002020
0222012002220002222222222000222002102220
0202002002022002000000002002202002002020
0202222222002202222222222022002222222020
0222000002222222000000002222222000002220
0202000002002002000000002002002000002020
0202000002002002000000002002002000002020
0222000002222222000000002222222000002220
0202222222002202222222222022002222222020
0202002002022002000000002002202002002020
0222012002220002222222222000222002102220
0202002002000002020000202000002002002020
0202222222222222022222202222222222222020
0200002002000020000000000200002002000020
0222222222222222222222222222222222222220
0000000000000000000000000000000000000000