1111111111111111111111111111111111111111
1000000000000000000000000000000000000001
1011110110111101111111111011110110111101
1010000000000000100000010000000000000101
1010110110111110101111010111110110110101
1000100110001110000000000111000110010001
1010110110100110111111110110010110110101
1010000000110010000000000100110000000101
1000111110000000111111110000000111110001
1010111110110110111111110110110111110101
1010111110110110111111110110110111110101
1000111110000000111111110000000111110001
1010000000110010000000000100110000000101
1010110110100110111111110110010110110101
1000100110001110000000000111000110010001
1010110110111110101111010111110110110101
1010000000000000100000010000000000000101
1011110110111101111111111011110110111101
1000000000000000000000000000000000000001
1111111111111111111111111111111111111111