1111111111111111111111111111111111111111
1222222222222222222222222222222222222221
1211112112111121111111111211112112111121
1212222222222222122222212222222222222121
1212112112111112121111212111112112112121
1222102112221112222222222111222112012221
1212112112122112111111112112212112112121
1212222222112212222222222122112222222121
1222111112222222111111112222222111112221
1212111112112112111111112112112111112121
1212111112112112111111112112112111112121
1222111112222222111111112222222111112221
1212222222112212222222222122112222222121
1212112112122112111111112112212112112121
1222102112221112222222222111222112012221
1212112112111112121111212111112112112121
1212222222222222122222212222222222222121
1211112112111121111111111211112112111121
1222222222222222222222222222222222222221
1111111111111111111111111111111111111111